----------------
----------------
----------------
NNNNNNNNNNNNNNNN
BNNNNNCNNNNNNNNN
NNNNNNNNNNNNNDNN
rrrrrrrrrrrrrrrr
rrrrrrrrrrrrrrrr
SSSSSTSSSSSSSDSS
SSSSSTEESSSSSSSS
SSSSSTEESSSSSSSS
ASSSSTSSSSSSSSSS
