----------------
----------------
----------------
NNNNNNNNNNNNTNNN
BNNNCNNNNNNNTUUN
NNNNNNNNNNNNTUUN
----------------
----------------
SSccSSppSSSSSSSS
SSccSSppSSSSSCSS
ASSTJJpppppppppp
SSSTJJpppppppppp
A
KLIUOJ
B
WQEWW


